zdać	zdana	V;PL;3;PRS
potencial	+?	N;GEN;PL
wosobinski	wosobinskim	ADJ;INS;MASC;SG
předskok	+?	N;ACC;SG
biografija	+?	N;ACC;SG
měć	+?	V;PL;3;FUT
łužica	+?	N;ACC;SG
wšelaki	wšelakeje	ADJ;GEN;FEM;SG
region	+?	N;LOC;SG
přizamknyć	+?	V;SG;3;PST
přiwzać	+?	V;PL;PST
strona	+?	N;GEN;PL
měć	+?	V;SG;2;PST
měć	mimoj	V;DU;1;PRS
kedźbliwje	kedźbliwje	ADV
prawy	prawych	ADJ;GEN;PL
organizować	organizowana	V;PL;3;PRS
dźěło	+?	N;ACC;SG
naš	našch	ADJ;GEN;PL
šuler	+?	N;GEN;PL
twarskoprawnisce	twarskoprawnisce	ADV
dźěłać	dźěłana	V;PL;3;PRS
přisadźić	přisadźił	V;MASC;SG;PST
tradicija	+?	N;INS;SG
wón	wón	ADJ;GEN;FEM;SG
přihłosować	přihłosowana	V;PL;3;PRS
sobustawstwo	+?	N;INS;SG
wokrjes	+?	N;GEN;PL
zaměr	+?	N;GEN;PL
partyjowy	partyjowych	ADJ;GEN;PL
Lubijski	Lubijskej	ADJ;LOC;FEM;SG
naprawa	+?	N;ACC;SG
serbski	serbskim	ADJ;INS;MASC;SG
poskićeć	poskića	V;PL;3;PRS
kónčina	+?	N;GEN;PL
być	bu	V;SG;1;PRS
skupina	+?	N;GEN;PL
kolij	+?	N;GEN;PL
namakać	namakaće	V;PL;2;PRS
sobota	+?	N;ACC;SG
pochadźeć	pochadźa	V;PL;3;PRS
nowotwar	+?	N;INS;SG
přeprošenje	+?	N;ACC;SG
wien	+?	N;LOC;SG
wukrajny	wukrajnych	ADJ;GEN;PL
tutón	tutych	ADJ;GEN;MASC;PL
wón	wóna	ADJ;NOM;SG
prašenje	+?	N;DAT;PL
dobry	dobre	ADJ;ACC;NEUT;SG
zakładna	+?	N;GEN;PL
myslić	+?	V;SG;2;PST
zhromadny	zhromadne	ADJ;ACC;NEUT;SG
ptačecy	+?	N;GEN;PL
spale	+?	N;GEN;PL
niwow	+?	N;INS;SG
němska	němskach	ADJ;GEN;PL
wjacory	wjacore	ADJ;ACC;NEUT;SG
azylowy	azyloweho	ADJ;ACC;MASC;SG
kraj	azylowa	N;LOC;SG
nańć	+?	V;MASC;SG;PST
hladać	nańł	V.CVB;PRS
knježerstwo	+?	N;LOC;SG
chwalić	+?	V;PL;PST
prajić	+?	V;PL;2;PRS
dźěža	prajiće	N;INS;SG
zwisk	+?	N;LOC;SG
muzej	+?	N;LOC;SG
poskićić	+?	V;DU;1;PRS
němski	poskićimoj	ADV
być	němski	V;SG;3;FUT
móc	+?	V;PL;3;PRS
wysoki	móca	ADJ;GEN;MASC;PL
partner	wyšich	N;GEN;PL
měrc	+?	N;LOC;SG
euro	+?	N;GEN;PL
zajimc	+?	N;GEN;PL
nora	+?	N;LOC;SG
ropot	+?	N;NOM;SG
žiwy	+?	ADJ;ACC;PL
wopytowar	žiwe	N;NOM;PL
